PLANIFICACION:

Jugadores - Atributos:
- Numero (Numero del jugador)
- EstadoJuego (Si es su turno)
- Mazo (Lista de 6 cartas que tendra el jugador)
Metodo:
- RecogerCarta(): Los jugadores podran recoger una carta del MazoJuego, cuando hagan esto se recogera la carta que este en la cabezera del MazoJuego
- JugarCarta(): Los jugadores Podran escoger una carta del mazo y jugarla, las reglas de la carta jugada se verificara en la clase Carta, si el jugador no puede jugar ninguna carta del mazo, se procedera a descartar una carta que elija y coger una del mazo del juego
- DescartarCarta(): El jugador es capaz de descartar una carta de su mazo al pozo
- PasarTurno(): Funcion unica para cambiar el estado de juego (O se puede hacer directamente en la funcion Jugar carta)

Equipos - Atributos:
- Jugadores: Jugadores que conforman al equipo
- Puntaje: Puntaje del equipo 
- MillasRecorridas: Millas recorridas en cada juego
Metodo:
- TurnoJugador(): Maneja Todo lo que puede hacer un jugador en su turno
- SumarMillas(): Suma las millas jugadas por cada jugador del equipo

ZONAS: las clases de zona se manejaran con el patron "factory" y se encargaran de manejar las restricciones para agregar cartas a la zona
- ZonaSeguridad: Lista de cartas (Usada para manejar alguna restricciones de la zona)
- ZonaPuja: Lista de cartas (Usada para manejar alguna restricciones de la zona)
- ZonaLimiteV: Lista de cartas (Usada para manejar alguna restricciones de la zona)
- ZonaDistancia: Lista de cartas (Usada para manejar alguna restricciones de la zona)


Cartas - Atributos: (INTERFACE)
- Nombre
Metodos:
- Funci√≥nCarta()
- Restriccion(): Verifica si la carta si se puede jugar y retorna true o false
NOTA: Cada tipo Hereda de cartas

MazoJuego - Atributos: (Patron Builder para la creacion de las cartas del mazo inicial)
- CartasDisponibles: List (Cartas disponibles en el mazo de juego)
- CartasDescartadas: List (Cartas desechadas en el pozo)
Metodo:
- ReolverCartas(): Metodo encargado de revolver todas las cartas
- DescontarCarta(): Metodo encargado de descontar las cartas del mazo del juego (No es necesario)

Juego - Atributos:
- Equipos: Equipos 
- MazoJuego
- Puntaje: Lista de puntaje para cada equipo
Metodo:
- IniciarCartas(): Crear las cartas 
- RecolectarCarta(): Recolecta todas las cartas del juego y las pone en el mazo del juego
- IniciarJuego(): Crear Equipos y el mazo del juego
- JugarRonda(): Logica para cada ronda de juego
- TerminarPartida(): Encargado de contar los puntos

